############################............#............##.####.#####.#.#####.####.##o####.#####.#.#####.####o##.####.#####.#.#####.####.##.........................##.####.##.#######.##.####.##.####.##.#######.##.####.##......##....#....##......#######.##### # #####.######     #.##### # #####.#          #.##         ##.#          #.## ###_### ##.#          #.   #     #   .#          #.## ####### ##.#          #.##         ##.#          #.## ####### ##.#     ######.## ####### ##.#######............#............##.####.#####.#.#####.####.##.####.#####.#.#####.####.##o..##...............##..o####.##.##.#######.##.##.######.##.##.#######.##.##.####......##....#....##......##.##########.#.##########.##.##########.#.##########.##.........................############################
############################      #           #      ## #### # ######### # #### ## #### # ######### # #### ##                         ##### # ##### # ##### # ####   # # ##### # ##### # #      # # ##### # ##### # #      # #       #       # #      # #### ####### #### #      # #### ####### #### #      #                   #      # #### ###_### #### #      # #    #     #    # #      # # ## ####### ## # #      #   ##         ##   #      # ####### # ####### #      # ####### # ####### #      #         #         #      # ##### ##### ##### #   #### ##### ##### ##### #####                         ## #### ##### # ##### #### ## #### ##    #    ## #### ## #### ## ####### ## #### ##      ## ####### ##      ## #### ## ####### ## #### ##                         ############################
############################         ##   ##         ## #### ## ## # ## ## #### ## #### ## ## # ## ## #### ## ##   ## ## # ## ##   ## ## ## ####    #    #### ## ## ## #### ####### #### ## ##      ## ####### ##      ## #### ##         ## #### ## #### ## ####### ## #### ##   ## ## ####### ## ##   #### ## ##         ## ## ###### ## ## ###_### ## ## ####         #     #         ## #### ## ####### ## #### ## #### ##         ## #### ## ##   ## ####### ##   ## ## ## #### ####### #### ## ## ## ####    #    #### ## ##            #            ## #### ##### # ##### #### ## #### #####   ##### #### ## ##      ## # ##      ## ## ## #### ## # ## #### ## ##      ## ## # ## ##      ## #### ##    #    ## #### ## #### ## ####### ## #### ##                         ############################
############################            #            ## #### ##### # ##### #### ## #### ##### # ##### #### ## ##      ## # ##      ## ## ## #### ##   ## #### ## ## ## #### ## # ## #### ## ##      ## ## # ## ##      ## #### ##    #    ## #### ## #### ## ####### ## #### ## #### ## ####### ## #### ##                         ## ## #### ###_### #### ## ## ##   ## #     # ##   ## ## #### ## ####### ## #### ##                         ## ########## # ########## ## ########## # ########## ##       ##   #   ##       ##### ## ## ##### ## ## ####   # ## ## ##### ## ## #      # ##             ## #      # ##### ##### ##### #   #### ##### ##### ##### #####                         ## #### ##### # ##### #### ## #### ##### # ##### #### ##                         ############################
############################      ##         ##      ## #### ## ####### ## #### ## #### ## ####### ## #### ##   ##       #       ##   #### ## ## ## # ## ## ## ###  # ## ## ## # ## ## ## #    # ## ## ## # ## ## ## #    #    ## ##   ## ##    #    # ##### ####### ##### #  ### ##### ####### ##### ####      ##         ##      ## #### ## ###_### ## #### ##         #     #         #### ##### ####### ##### ###  # #####         ##### #    #    ## ####### ##    #    #### ## ####### ## ####       #       #       #          # ##### # ##### #     ###### ##### # ##### #######         ##   ##         ## ####### ## # ## ####### ## ####### ## # ## ####### ##      ##    #    ##      ## #### ## ####### ## #### ## #### ## ####### ## #### ##                         ############################
############################                         ## ####### ####### ####### ## ####### ####### ####### ##      ## ##   ## ##      ####### ## ## # ## ## ######     # ## ## # ## ## #          # ## ## # ## ## #          #       #       #          # ## ####### ## #       #### ## ####### ## ####    #    ##         ##    #    # ##### ###_### ##### #    #    ## #     # ##    #  ### ## ## ####### ## ## ####   ##               ##   ## #### ## ####### ## #### ## #### ## ####### ## #### ##      ##    #    ##      #### ##### ## # ## ##### ###  # ##### ## # ## ##### #    #       ##   ##       #    # ## ##### # ##### ## #  ### ## ##### # ##### ## ####   ##       #       ##   ## ######## ##### ######## ## ######## ##### ######## ##                         ############################

